xdxxxxxxxxxxx
x      o    x
x xx xxx xx x
x x       x x
x x xxxxx x x
x   xd e  x x
x x     x  ox
x x xxxxx x x
x x     o x x
x xxx x xxd x
x o         x
xxxxxxxxxxxxx
