xdxxxxxxxxxxx
x  m    o  mx
x xx xxx xx x
x x       xox
x x xxxxx x x
x o xd e  x x
x x     x  ox
x x xxxxx x x
x x     o x x
xoxxx x xxd x
xmo         x
xxxxxxxxxxxxx
